NO maps/textures/cosmos/c1.xpm
SO maps/textures/cosmos/c3.xpm
WE maps/textures/cosmos/c5.xpm
EA maps/textures/cosmos/c6.xpm

C 0,0,0
F 0,0,0

111111111111111111111111111111111111111111
100000000000000000000000000000000000101
100010000000100000100000000000000001001
101000010101010000000100010000000000101
100100000100000100000000010000100000001
100000000000100000001000000100000010001
100001000000100001000000100000100000001
100000001000000100000000000000010000001
100001000010101000000010000000000010001
100100000000101001000000010000100000001
111111111111101111111111111111111111111111111111
100000000000101000000000000000000000000000000001
101000001000000001100000000100000000000000000001
111000001111111111000000000111111111111111111111
1000000000000000010000000000000000000000011
10000000000000010110000000100000000000000011
11000000100000011111000000000000000000000001
11110111111101111111100001111111111110111111
10000000000000000000000000000000000000000001
11110000011100000111111111111111111111111111
1000000001E0000000000001
111111111111111111111111
