NO maps/textures/other/sky1.xpm
SO maps/textures/other/sky1.xpm
WE maps/textures/other/sky1.xpm
EA maps/textures/other/sky1.xpm

C 18,238,238
F 18,150,238

11111
1N001
111